NO ./img/squares/dali3.png
SO ./img/squares/vangogh.png
WE ./img/squares/rooftops.png
EA ./img/squares/irises.png

F 145,214,185
C 19,93,135

        1111111111111111111111111
        1000000000110000000000001
        1000000001110000000000001
        1000000000000000000000001
111111111000000001110000000000001
100000000000010001110111111111111
11110000111111011100000010001
11110000111111011101010010001
1100000011D10101110000001d001
10000000000000001100000010001
10000000000000001101010010001
1100N0011101010111110111100111
11110111 1110101 101111010001
11111111 1111111 111111111111
