NO ./img/dali1.png
SO ./img/vangogh.png
WE ./img/clock.png
EA ./img/irises.png

F 220,100,0
C 225,30,0

        1111111111111111111111111
        1000000000110000000000001
        1011000001110000000000001
        1001000000000000000000001
111111111011000001110000000000001
100000000011000001110111111111111
11110111111111011100000010001
11110111111111011101010010001
1100000011D10101110000001d001
10000000000000001100000010001
10000000000000001101010010001
1100N0011101010111110111100111
11110111 1110101 101111010001
11111111 1111111 111111111111
